XXXXXXXXXXXXXXXXXXXXXXXXXXXXXXXXXXXXXXXXXXXXXXXXXXXXXXXXXXXXXXXXXXXXXXXXXXXXXXXXXXXXXXXXXXXXXXXXXXXXXXXX
XS0000X000000000000000000XXXXXXXXXXXXXXXXXXXXXXXXXXXXXXXXXXXXXXXXXXXXXXXXXXXXXXXXXXXXXXXXXXXXXXXXXXXXXXX
X00000X0000000000000XX000XX00000X0000000000000XX000XX00000X0000000000000XX000XX00000X0000000000000XX000X
X00X000000000000000000000XX00000X0000000000000XX000XX00000X0000000000000XX000XX00000X0000000000000XX000X
X00000X00000X0000XX000000XX00000X0000000000000XX000XX00000X0000000000000XX000XX00000X0000000000000XX000X
X00000XXXXXXX000000000000XX00000X0000000000000XX000XX00000X0000000000000XX000XX00000X0000000000000XX000X
XX0XXXX00000X000000000000XX00000X0000000000000XX000XX00000X0000000000000XX000XX00000X0000000000000XX000X
X00000000000X000XXXXXXXXXXX00000X0000000000000XX000XX00000X0000000000000XX000XX00000X0000000000000XX000X
X00000000000X000000X00000XX00000X0000000000000XX000XX00000X0000000000000XX000XX00000X0000000000000XX000X
XXXX00000000X000X00000000XX00000X0000000000000XX000XX00000X0000000000000XX000XX00000X0000000000000XX000X
X00X00000000000XX00X00000XX00000X0000000000000XX000XX00000X0000000000000XX000XX00000X0000000000000XX000X
X00X00XXXXXXX00000000XX00XX00000X0000000000000XX000XX00000X0000000000000XX000XX00000X0000000000000XX000X
X00000000000X000X00X00000XX00000X0000000000000XX000XX00000X0000000000000XX000XX00000X0000000000000XX000X
X00000000000XXXXXX0XXXX0XXX00000000000XXXXXX0XXXX0XXX00000000000XXXXXX0XXXX0XXX00000000000XXXXXX0XXXX0XX
X000000000000000000X00000XX000000000000000000X00000XX000000000000000000X00000XX000000000000000000X00000X
X000X00000000000000X00000XX000000000000000000X00000XX000000000000000000X00000XX000000000000000000X00000X
X000000000000000000X00000XX000000000000000000X00000XX000000000000000000X00000XX000000000000000000X00000X
X0000000X0000000000X00000XX000000000000000000X00000XX000000000000000000X00000XX000000000000000000X00000X
X0000000XXXXXXXXXXXX00000XX000000000000000000X00000XX000000000000000000X00000XX000000000000000000X00000X
X0000000X000000000X000000XX000000000000000000X00000XX000000000000000000X00000XX000000000000000000X00000X
X0000000X000000000X0XXXXXXX000000000000000000X00000XX000000000000000000X00000XX000000000000000000X00000X
X0000000X0000000X00000000XX000000000000000000X00000XX000000000000000000X00000XX000000000000000000X00000X
X000000000000000X00000000XX00000000000000000000000000000000000000000000X00000XX000000000000000000X00000X
X0000000X0000000X00000000XX000000000000000000X00000XX000000000000000000X00000XX000000000000000000X00000X
XXXXXXXXXXX000000000000XXXX000000000000000000X00000XX000000000000000000X00000XX000000000000000000X00000X
X00000X000000000000000000XX000000000000000000X00000XX000000000000000000X00000XX000000000000000000X00000X
X00000X0000000000000XX000XX000000000000000000X00000XX000000000000000000X00000XX000000000000000000X00000X
X00X000000000000000000000XX000000000000000000X00000XX000000000000000000X00000XX000000000000000000X00000X
X00000X00000X0000XX000000XX000000000000000000X00000XX000000000000000000X00000XX000000000000000000X00000X
X00000XXXXXXX000000000000XX000000000000000000X00000XX000000000000000000X00000XX000000000000000000X00000X
XX0XXXX00000X000000000000XX000000000000000000X00000XX000000000000000000X00000XX000000000000000000X00000X
X00000000000X000XXXXXXXXXXX000000000000000000X00000XX000000000000000000X00000XX000000000000000000X00000X
X00000000000X000000X00000XX000000000000000000X00000XX000000000000000000X00000XX000000000000000000X00000X
XXXX00000000X000X0000000000000000000000000000X00000XX000000000000000000X00000XX000000000000000000X00000X
X00X00000000000XX00X00000XX000000000000000000X00000XX000000000000000000X00000XX000000000000000000X00000X
X00X00XXXXXXX00000000XX00XX000000000000000000X00000XX000000000000000000X00000XX000000000000000000X00000X
X00000000000X000X00X00000XX000000000000000000X00000XX000000000000000000X00000XX000000000000000000X00000X
X00000000000XXXXXX0XXXX0XXX000000000000000000X00000XX000000000000000000X00000XX000000000000000000X00000X
X000000000000000000X00000XX000000000000000000X00000XX000000000000000000X00000XX000000000000000000X00000X
X000X00000000000000X00000XX000000000000000000X00000XX000000000000000000X00000XX000000000000000000X00000X
X000000000000000000X00000XX000000000000000000X00000XX000000000000000000X00000XX000000000000000000X00000X
X0000000X0000000000X00000XX000000000000000000X00000XX00000000000000000000000000000000000000000000X00000X
X0000000XXXXXXXXXXXX00000XX000000000000000000X00000XX000000000000000000X00000XX000000000000000000X00000X
X0000000X000000000X000000XX000000000000000000X00000XX000000000000000000X00000XX000000000000000000X00000X
X0000000X000000000X0XXXXXXX000000000000000000X00000XX000000000000000000X00000XX000000000000000000X00000X
X0000000X0000000X00000000XX000000000000000000X00000XX000000000000000000X00000XX0000000000G0000000X00000X
X000000000000000X00000000XX000000000000000000X00000XX000000000000000000X00000XX000000000000000000X00000X
X0000000X0000000X00000000XX000000000000000000X00000XX000000000000000000X00000XX000000000000000000X00000X
XXXXXXXXXXXXXXXXXXXXXXXXXXXXXXXXXXXXXXXXXXXXXXXXXXXXXXXXXXXXXXXXXXXXXXXXXXXXXXXXXXXXXXXXXXXXXXXXXXXXXXXX